....@....
.#.....#.
.#.....#.
.........
.#.....#.
..#####..
.........
#.#...#.#
##.....#.
#.#....#.